20 10 10 10 10 10 10 10 10 10 10
20  0  0  0  0  X  0  0  0  0 40
10  0  0  0  0  0  0  0  0  0 40
20  0 50  0 50  0 50  0 50  0 40
20  0  0  0  0  0  0  0  0  0 40
20  0 60  0 60  0 60  0 60  0 40
20  0  0  0  0  0  0  0  0  0 40
20  0 70  0 70  0 70  0 70  0 40
20  0  0  0  0  0  0  0  0  0 40
20 30 30 30 30 30 30 30 30 30 40
